##X#######
#..#.#.#.#
#.##.....#
#.#..#.###
#.####.###
#.##.....#
#.##.###.#
#........#
#.######.#
########E#