#######################################################################
#...#.....#...#.....#...................#.......#...#.........#.....#.#
###.###.###.#.#.#.#.#################.#.#####.#.#.#.#.#####.#.###.#.#.#
#.#...#.#...#...#.#.....#.......#.....#.#.....#.#.#.#...#...#.#...#...#
#.###.#.#.#######.#####.#.#####.#.#####.#.#####.###.###.#.###.#.#####.#
#.....#.........#.....#.#...#.#...#...#...#...#.#.....#.#.#.#.#...#...#
#.###################.#.###.#.#####.#######.#.#.#.#####.#.#.#.###.#.###
#.#.......#.....#...#.#.#...#.............#.#.#.#.......#.#.#.#...#.#.#
E.###.###.#.###.#.#.#.#.#.#############.#.#.#.#.#########.#.#.#.###.#X#
#...#.#...#.#.#...#...#.#.....#.......#.#...#.#.....#.....#...#...#...#
###.#.#.###.#.#########.#.###.#.#####.#.#####.#####.#.#####.###.#.#####
#.#...#.....#.......#.#.#.#.#...#.#...#.....#.....#...#...#.#...#.....#
#.###############.#.#.#.#.#.#####.#.###.#######.#######.###.#########.#
#.........#.......#...#.#.#.......#.#...#.......#.....#.....#.......#.#
###.#######.#.#####.###.#.#.#######.#.###.#####.#.###.#.#####.#####.#.#
#...#.......#...#...#...#.#.#.......#.#.#...#...#...#...#.......#.....#
#.###.#########.#.###.###.#.#.#######.#.###.#######.#####.#####.#######
#...#.#.......#.#...#.#.#...#.#.....#.#...#.........#...#.....#...#...#
#.#.#.###.#####.#.###.#.###.#.#.#####.#.###############.#####.###.#.#.#
#.#.#.#...#.....#.#...#.....#.#.....#.#...............#.#...#.#.#...#.#
###.#.#.#.#.#######.###.#####.#.###.#.#####.#########.#.#.#.#.#.#####.#
#...#...#.#.........#.....#...#.#...#...#...#...#...#.#...#...#...#...#
#.#######.#################.###.#.#####.#.#.#.#.#.###.#######.#.#.#.#.#
#.......#.#.....#.....#...#...#.#.....#.#.#.#.#.#...#...#...#.#.#.#.#.#
#.#.#####.###.#.#.#.#.#.#.#.#.#.#####.#.#.###.#.#.#.###.#.#.#.###.#.#.#
#.#.#...#...#.#.#.#.#...#.#.#.#...#.#.#.#...#.#.#.#...#.#.#.#.....#.#.#
###.#.#.###.#.#.#.#.#####.#.#.###.#.#.#.###.#.#.#.###.#.#.#.#######.#.#
#...#.#...#...#.#.#.#.#...#.#...#.#.#.#...#...#.#.#.#...#.#.#.......#.#
#.###.#.#######.###.#.#.#######.#.#.#.###.#####.#.#.#####.#.#.#######.#
#.....#.............#...........#...#...........#.........#...#.......#
#######################################################################