#######
#.....#
#.###.#
#.#X#.#
#.#...#
#.#####
#.....E
#######